###############
E             #
# #### # ###  #
# #### # ###  #
# ###### # #  #
# ####   # #  #
# ######## ## #
# ###      ## #
#     ####### #
#############S#